



NO ./textures/wall/new/NO.xpm

SO ./textures/wall/new/SO.xpm

WE ./textures/wall/new/WE.xpm

EA ./textures/wall/new/EA.xpm

F 100,100,100
C 20,20,20

        1111111111111111111111111
        1000000000110000000000001
        1011000001110000001000001
        1001000000000000000000001
111111111011000001110000000000001
100000000011001001110111100111111
11110111111111111000000100001
11110111111     1101010010001
11000000111111111100000000001
10001000000000001100000010001
10000000000000000001010010001
11000001110101011111011000N01
11110111 1110101 101111010001
11110111 1110101 101111010001
11111111 1111111 111111111111
