



NO ./textures/wall/NO.xpm
SO ./textures/wall/SO.xpm
WE ./textures/wall/WE.xpm
EA ./textures/wall/EA.xpm

F 255,255,255
C 188,188,188

        1111111111111111111111111
        1000000000110000000000001
        1011000001110000001000001
        1001000000000000000000001
111111111011000001110000000000001
100000000011001001110111111111111
1111011111111111100000010001
11110111111     1101010010001
11000000111111111100000010001
10001000000000000000000000001
10000000000000001101010010001
11000001110101011111011110001
11000001110101011111011110N01
11000001110101011111011110N01
11000001110101011111011110N01
11000001110101011111011110N01
11000001110101011111011110N01
11000001110101011111011110N01
11000001110101011111011110N01
11000001110101011111011110N01
11110111 1110101 101111010001
11111111 1111111 111111111111


